1111111111111111
1001000000C000E1
1000001000000001
1000111110100001
1100000000000001
1111000010000001
1000000000000001
1101000000001001
1111000000000001
1P00000000001101
1111111111111111
