1111111111111111
10000000000000E1
1C00001000000001
1000111110100001
1100000011101111
1111000010000001
1000000000000001
1101000000001001
1000001111100001
1P00000000001101
1111111111111111