1111111111111111
1001000000C000E1
1000001000111111
1000111110100001
1100000011101111
1111000010000001
1000001111111101
1101000000001001
1111001111100001
1P00000000001101
1111111111111111
