1111111111111111111111111111111
100001000000010001111001C000001
101001111001000C000000011111001
1011110000111111111110000010001
1001000011100000000011100000111
1111000110000111110000110010001
1001101100011100011100011011001
101100100001000C000100001001001
1001011000011100011100001111001
1011010011000110110001100101101
100101C010000000000000100100101
1011111111111000001111111100001
1010010000100000000010000100001
101000000000000E000000000000001
1010110010000001000000100100001
1010010010010001000100100111111
10110101111100010001111101C1001
1010010000010001000100000100001
1011011011111001001111101101001
1001001001100001000011001001001
10010011001110C1C01110011001101
1001000110001111111000110001001
10010000111000C1C00011100001001
1000010000111111111110000111101
1011110010000101010000001100001
1010011111000100011111000111001
101C000000010000000000000000001
1111111111111111111111111111101
1P00000000000000000000000000001
1111111111111111111111111111111
