1111111111111111
1000000000000001
1000000000000001
1000000000000001
1000000000000001
1000000000000011
1000000000000EP1
1000000000000C01
1111111111111111
