1111111111111111
1000000010000001
10000001C0000001
1000000010000001
1000000000000001
1100000000000011
10P10000000001E1
10100000C0000001
1111111111111111
