1111111111111111
1000000010000001
10000001C0000001
1P00000010000001
1000000000000001
1010000000000011
10010000000000E1
1C10000000000011
1111111111111111
