1111111111111111
1C010000000000E1
1000001000111001
100011111C100001
1100000011101111
1111000010000001
1000001111111101
1101000000001001
1001001111100001
1P010000000011C1
1111111111111111
