1111111111111111111111111111111111111111111111111111111111111111111111111111111111111
1E00000000000000000000000000000000000000000C00000000000000000000000000000000000000001
1000000000000000000000000000000000000000000000000000000000000000000000000000000000001
1000000000000000000111111111111111111000000000000000000000000000000000000000000000001
1000000000000000000000000000000000000000000000000000000000000000000000000000000000001
1000000000000000000000000000000000000000000000000000000000000000000000000000000000001
1111111111111111110000000000000000000000000000000000000000000000000000000000000000001
1C00000000000000000000011111111111111111111100000000000000000000000000000000000000001
1100000000000000000000000000000000000000000000000000000000000000000000000000000000001
1000000000001111111111111111111111110000000000000000000000000000000000000000000000001
1000000000000000000000000000000000000000000000000000000000000000000000000000000C00001
1000011111110000000000000000000000000000000000000000000000000000000000000000000000001
1000000000000000000000000000000000000000000000000000000000000000000000000000000000001
1000000000000000000000000011111111111111111111110000000000000000000000000000000000001
1000000000000000000000000000000000000000000000000000000000000000000000000000000000001
10001111111111111111111000000000000000000000000C000CC00000000000000000000000000000001
10000000000000000000000000000P0000000000000000000000000000000000000000000000000000001
100000000C0000000000000000000000000000000000000C000CC00000000000000000000000000000001
1000000000000001111111111111111111111000000000000000000000000000000000000000000000001
11111111111111111111100000000000000000000000000C0000000000000000000000000000000000001
1000000000000000000000000000000000000000000000000000000000000000000000000000000000001
1000000000000000000111111111111111111111110000000000000000000000000000000000000000001
1000000000000000000000000000000000000000000000000000000000000000000000000000000000001
1000000000011111111111111111111111100000000000000000000000000000000000000000000000001
1000000000000000000000000000000000000000000000000000000000000000000000000000000C00001
1000011111110000000000000000000000000000000000000000000000000000000000000000000000001
1000000000000000000000000000000000000000000000000000000000000000000000000000000000001
1000000000000000000000000011111111111111111111110000000000000000000000000000000000001
1000000000000000000000000000000000000000000000000000000000000000000000000000000000001
1000111111111111111111100000000000000000000000000000000000000000000000000000000000001
1000000000000000000000000000000000000000000000000000000000000000000000000000000000001
100000000C000000000000000000000000000000000000000000000000000000000000000000000000001
1000000000000001111111111111111111111000000000000000000000000000000000000000000000001
1111111111111111111110000000000000000000000000000000000000000000000000000000000000001
1000000000000000000000000000000000000000000000000000000000000000000000000000000000001
1000000000000000000111111111111111111111110000000000000000000000000000000000000000001
1000000000000000000000000000000000000000000000000000000000000000000000000000000000001
1111111111111111111111111111111111111111111111111111111111111111111111111111111111111
